NO ./imgs/joconde_1.xpm 
SO ./imgs/cri_1.xpm
WE ./imgs/starry_1.xpm
EA ./imgs/time_1.xpm
F 220,100,0
C 225,30,0
1111111111111111111111111
1000000000110000000000001
10110000011100000000N00011111
10010000000000000000000000001
11111111101100000111000011111
1000000000110000011101111
1111011111111101110000001
1111111111111111111111111