       NO         ./imgs/joconde_1.xpm        


SO ./imgs/cri_1.xpm
WE ./imgs/starry_1.xpm




             F     220,100, 0             

C 225,30,0




EA ./imgs/time_1.xpm





111111111111111111111111111111111111111111
10N001
100001                                      
111111






