NO ./path_to_the_north_texture
SO ./path_to_the_south_texture
WE ./path_to_the_west_texture
EA ./path_to_the_east_texture
F 220,100,0
C 225,30,0
1111111111111111111111111
1000000000110000000000001
10110000011100000000N0001
1001000000000000000000001
1111111110110000011100000
1000000000110000011101111
1111011111111101110000001
1111111111111111111111111