NO ./imgs/joconde_1.xpm 
SO ./imgs/cri_1.xpm
WE ./imgs/starry_1.xpm
EA ./imgs/god.xpm
F 200,200,200
C 0,0,100
1111111111111111111111111
10000000000000000000000N1
1011000111111111110000001
1000000000000000000000001
1101111100000000001100001
1000000111111111111101111
1000000000000000000000001
1111111111111111111111111
