    NO         ./imgs/joconde_1.xpm        


WE ./imgs/starry_1.xpm

PO ./imgs/door.xpm
SO ./imgs/cri_1.xpm



             F     220,100,0             

C     000,123,000




EA ./imgs/time_1.xpm





 1111
10N001
100001        11111                          
100001        10001                                  
10P001        10001                          
100001        111111111                          
100001                                      
1000011111                                      
10000000001                            
 111111111 















