NO ./imgs/joconde_1.xpm 
SO ./imgs/cri_1.xpm
WE ./imgs/starry_1.xpm
EA ./imgs/time_1.xpm
PO ./imgs/door.xpm
F 200,200,200
C 0,0,100
1111111111111111111111111111111111111111111
100000000011000000000000P000000000000000001
10110000011100000000N0001111111111011111111
1001000000P00000000000001000000100000000001
111111111011000001110000P000000100000011111
10000P0000110000011101111111P1110000001
111101111111110111000000111100000000001
111111111111111111111111111111111111111