NO ./imgs/joconde_1.xpm 
SO ./imgs/cri_1.xpm
WE ./imgs/starry_1.xpm
EA ./imgs/time_1.xpm
PO ./imgs/door.xpm
F 220,100,0
C 225,30,0
1111111111
1000000001
1P000N0111
1000000001
1111111111